pip search django -> Gives us massive list of stuff.  Search for keyworks

bundled in django:  Imagefield class -> Used for uploading images into Django Server using a web interface REQUIRES PILLOW LIBRARY



https://pypi.python.org/pypi/mysociety-django-images/0.0.5 :: This seems good, since my images are strongly related to models



Mature:  Django-image-tools2:  Mature, but lacks the feature I need I think......

django-tint:  contrast maximization, normalizing, cropping, resizing

django-media-helper 0.3.1, django-multires:  Automagically resizes images appropriate to browser.

django-thumbs 0.4:  ``The easiest way to create thumbnails of your images with Django.

django_cropper 0.1.4a:  Uses Jcrop, JQuery plugin to make crops dynamic. *****Best so far*****


django-cropduster:      Django image uploader and cropping tool






django-thumbnail-works          - django-thumbnail-works adds thumbnail support to the default ImageField.

django-primitivegallery         - A simple image gallery.

django-versatileimagefield      - A drop-in replacement for django's ImageField that provides a flexible, intuitive and easily-extensiblem interface for creating new images from the one assigned to the field.

django-filero                   - A file management application for django that makes handling of files and images a breeze.

django-extended-image-field                                    - Django Image Field with thumbnails creator

django-ajaximage                                               - Upload images via ajax. Images are optionally resized.

django-image-cropping                                          - A reusable app for cropping images easily and non-destructively in Django

django-contentadmin                                            - Templatetags that let you modify text and images directly in the django admin

django-photoprocessor                                          - Automated image processing for Django.

django-cropduster                                              - Django image uploader and cropping tool

*****************
django-jcrop                                                   - ('Django app providing cropping functionnality with jcrop',)
******************

appomatic_photolog                                             - Photologue is a reusable Django application that provides powerful image management and manipulation

*********************
django-multires                                                - Django-multires is a plug-and-play Django app for managing multiple image resolutions in a db-driven approach.
*********************

********************
django-deepzoom                                                - A simple Django app to create deep zoom tiled images.
********************
django-openzoom                                                - Django application for displaying very high resolution images
*********************
django-image-loupe                                             - A high resolution image manager for pan and zooming into images
************************

django-image-cropper                                           - This app allows upload and crop images

django-croppic                                                 - A Django package which uses Croppic.net to upload and crop images.


django-dropimages                                              - Uses Dropzone.js and django-braces to simplify the upload of multiple images into a collection object.

django-image-tools-2                                           - Image tools for Django


django-image                                                   - Simple pluggable framework for displaying images in Django

django-croppy                                                  - Django model field to store custom image crops

django-flexible-images                                         - A responsive image solution for Django.

django-image-helper                                            - Django helpers for working with images.

django-naremitimg                                              - A tiny Django app for performing image manipulations on the fly.

django-imagekit-cropper                                        - Allow users to manually specify image variant crops


django-generic-images                                          - Generic images pluggable django app

django-interactive                                             - Building easier client-side connections



